#######
#--#--#
#--#--#
#--#--#
eb----#
#-----#
???####
LEFT
